1  1  1  1  1  2  2  2  2  2  1  1  1  1  
1  0  0  0  0  0  0  0  0  0  1  1  1  1  
1  0  0  0  0  0  0  0  0  0  1  1  1  1  
1  0  0  0  0  0  0  0  0  0  1  1  1  1  
1  0  0  0  0  0  0  0  0  0  1  1  1  1  
1  0  0  0  0  0  0  0  0  1  1  1  1  1  
1  0  0  0  0  0  0  0  0  1  4  0  0  1  
1  W3 W3 0  0  0  0  0  0  1  0  0  0  1  
1  0  0  0  0  0  0  0  0  0  0  0  0  1  
1  1  1  1  1  1  1  1  1  1  1  E1 E2 1  